WWWWWWWWWW
WTTTWTWTWW
WTWTWDSTWW
WTPTWTWTWW
WTTTETWTWW
WTWTWTDWWW
WTWTWTTTWW
WTWTWSTWWW
WTTTTWTETW
WWWWWWWWWW
