WWWWWWWWWW
WWTTTSTTTW
WTTTDDDTTW
WTTTTTTTTW
WTTSTTTETW
WTTTTSTTTW
WTWTWDDTTW
WTTTTPTTTW
WWWWWWWWWW
