WWWWWWWWWW
WPTTTETTTW
WTTTTTTTTW
WTTTWTWTWW
WTTTTTTTTW
WTWTWTWTWW
WTTTTTTTTW
WTTTETTTTW
WWWWWWWWWW
